
Fish — The Fluidinfo Shell
**************************

**Overview**

* An Overview of the Fish Command Line for Fluidinfo
* Shell-Fish: The Online version of Fish
**Commands for Reading and Writing Tags**

* tag — adds tags to objects
* untag — removes tags from objects
* show — shows the values of tags on objects
* get — gets the values (only) of tags on objects
* tags — shows all the tags on an object with their values
* count — counts the number of objects satisfying a query
**Search**

* search — searches about tags
**Commands for Listing and Managing Tags and Namespaces**

* ls — lists tags and namespaces and their properties
* perms — sets access permissions on tags and namespaces
* rm — removes tags and namespaces
* touch — creates a tags and optionally sets their descriptions
* mkns — makes a new namespace
* pwd (or pwn) — prints the name of the working directory (root user
  namespace)
**Commands for Finding About Tags**

* abouttag — returns the canonical about tag for an object based on
  properties
* amazon — finds the about tag for an item specified by an Amazon
  product page
* normalize — performs canonical normalization for use with about tags
**Cache & Aliases**

* showcache — shows the contents of the Fish cache
* sync — synchronizes the Fish cache with Fluidinfo
* alias — create or show Fish aliases
* unalias — delete an alias
* init — initialize fish
**Sequences**

* mkseq — make a new sequence
* seq — adds to a sequence
* listseq — lists items in or searches a sequence
**Miscellaneous Commands**

* help — provides help overview or help with a specific fish command
* commands — lists the fish commands available
* version — prints fish's version number
* su — sets the Fluidinfo user
* whoami — prints the name of the current Fluidinfo user
* quit — quits fish
* test — runs fish's test suite
**Installation and Configuration**

* Using Unix-Like Paths
* Installation and Configuration